**************************
*S* *                    *
* * *  *  *************  *
* *   *    ************  *
*    *                   *
************** ***********
*                        *
** ***********************
*      *              G  *
*  *      *********** *  *
*    *        ******* *  *
*       *                *
**************************
