**************************
*S                       *
*                        *
*                        *
*                        *
*                        *
*                        *
*                        *
*                        *
*                        *
*                        *
*                       G*
**************************
